11111111111111111111
100000000000100000C1
10000000000110000011
1C0000C00001000C1001
100000001C000P000001
1000000000C000000001
10000010000000100001
1100E0C0000000100C01
10000000000000000001
11111111111111111111