111111111
100010101
10000C001
100000E01
10C010011
10C000P01
100000001
111111111