11111111111
10000111001
100000C0001
10001000C01
1000000C001
1011C00C101
100C0000C01
10000000001
1000C0000C1
10000000001
1000000C001
1C00000E001
10C00010C01
100000P0001
10000000001
101000010C1
10CCCC000C1
100C0010101
10100C00001
100C0CC0001
10001C000C1
1000C000001
1000000C001
10000000001
11111111111