1111111111111111111
1010C000000C010CC11
10C0000000000001001
100CC00000110001001
100CC0010C1C1010001
11010C010C0PC01E001
1111111111111111111