1111111111111
10000010P0E01
1000C00010C11
100C01100C001
1010000010011
1000000110001
1000010000001
1000000000001
1111111111111