111111111
100000001
10C000001
100000011
100C00001
100000001
100000C01
100000001
100000001
10C0000C1
1C0CC0001
11C0C0001
10C0C0001
1000E0001
100000001
1P0C00001
100000001
100C00001
100000001
111111111