111111111111111111
100000001000000001
10001C100100000001
1001110000000C0001
10000011C00101C001
10C000000C01C10001
1C00100C0000000001
1000000001000000C1
100000100000E00C01
1000010000000000C1
101C000010000000C1
1000001000P1100001
111111111111111111